Config=Config
DamageConfig=Config/DamageConfig.asset
EnemyConfig=Config/EnemyConfig.asset
Prefab=Prefab
Effect=Prefab/Effect
ExplosionEffectPrefab=Prefab/Effect/ExplosionEffectPrefab
HitEffectPrefab=Prefab/Effect/HitEffectPrefab
MuzzleEffectPrefab=Prefab/Effect/MuzzleEffectPrefab
Enemy=Prefab/Enemy
Heavy=Prefab/Enemy/Heavy
EnemyFlamerPrefab=Prefab/Enemy/Heavy/EnemyFlamerPrefab
EnemyGatlingPrefab=Prefab/Enemy/Heavy/EnemyGatlingPrefab
EnemyGaussPrefab=Prefab/Enemy/Heavy/EnemyGaussPrefab
Light=Prefab/Enemy/Light
EnemyBombPrefab=Prefab/Enemy/Light/EnemyBombPrefab
EnemyScoutPrefab=Prefab/Enemy/Light/EnemyScoutPrefab
EnemyTeslaGunPrefab=Prefab/Enemy/Light/EnemyTeslaGunPrefab
Medium=Prefab/Enemy/Medium
EnemyDeminerPrefab=Prefab/Enemy/Medium/EnemyDeminerPrefab
EnemyFlakPrefab=Prefab/Enemy/Medium/EnemyFlakPrefab
EnemyShotgunPrefab=Prefab/Enemy/Medium/EnemyShotgunPrefab
GameScene=Prefab/GameScene
ArrowPrefab=Prefab/GameScene/ArrowPrefab
DestinationPrefab=Prefab/GameScene/DestinationPrefab
EmptyPrefab=Prefab/GameScene/EmptyPrefab
RoadPrefab=Prefab/GameScene/RoadPrefab
ShellPrefab=Prefab/GameScene/ShellPrefab
SpawnPointPrefab=Prefab/GameScene/SpawnPointPrefab
WallPrefab=Prefab/GameScene/WallPrefab
Tower=Prefab/Tower
CannonTowerPrefab=Prefab/Tower/CannonTowerPrefab
LaserTowerPrefab=Prefab/Tower/LaserTowerPrefab
MachineGunTowerPrefab=Prefab/Tower/MachineGunTowerPrefab
UI=Prefab/UI
UIGameScene=Prefab/UI/UIGameScene
UIMainScene=Prefab/UI/UIMainScene
UIPausePanel=Prefab/UI/UIPausePanel
